f f f f f f f f f f f f f f f f f f f f
f f f f # # # f f f f f f # # # f f f f
f 1 f f # f f f f f f f f f f # f f 2 f
f f f f f f f f R R R f f f f f f f f f
f f , , , , f f R R R f f , , , , f f f
f f , , , , , f f f f f , , , , , f f f
f f f f , , , , f f f , , , , f f f f f
f f f f f f , , , , , , , f f f f f f f
f f f C C f f f f f f f f f C C f f f f
f f f C C f f f f f f f f f C C f f f f
f f f f f f f f f f f f f f f f f f f f
f f f f f f f f f f f f f f f f f f f f
f f f f f f f f f f f f f f f f f f f f
f f f f f f f f f f f f f f f f f f f f
f f f C C f f f f f f f f f C C f f f f
f f f C C f f f f f f f f f C C f f f f
f f f f f f , , , , , , , f f f f f f f
f f f f , , , , f f f , , , , f f f f f
f f , , , , , f f f f f , , , , , f f f
f f , , , , f f R R R f f , , , , f f f
f f f f f f f f R R R f f f f f f f f f
f 2 f f # f f f f f f f f f f # f f 1 f
f f f f # # # f f f f f f # # # f f f f
f f f f f f f f f f f f f f f f f f f f