........
.W....W.
........
P.C...S.
........
.W....W.
........
........