............
.W.....W....
............
P.........S.
............
.....C......
............
.W.....W....
............
.....B......
............
............